border_size=1
usage=map

Xu, Xu, Xu, Xu, Ms^Xm, Ms^Xm, Ha, Ha, Ms, Wot, Wwt, Wwt, Wwt, Wwt, Wwt, Wwt, Wwt, Wwt, Wot, Md^Xm, Dd, Dd, Dd, Dd, Xu, Xu, Xu, Xu
Xu, Xu, Xu, Xu, Ha, Ms, Ha^Vhha, Ha, Ms^Xm, Wot, Wwt, Wwf^Ecf, Wwt, Wwt, Wwt, Wwf^Ecf, Wwt, Wwt, Wot, Md^Xm, Hd, Dd^Vdt, Hd, Dd, Xu, Xu, Xu, Xu
Xu, Uh^Ecf, Qlf, Xu, Ha, Ha, Ha, Ha, Ms, Wot, Wot, Wwt, Wwt, Wwt, Wwt, Wwt, Wot, Wot, Gs, Md, Dd^Dc, Hd, Rd, Dd, Xu, Xu, Xu, Xu
Xu, Qlf, Ql, Xu, Aa, Ms, Ha, Rb, Aa, Ai, Wwt, Wot, Wot, Ww^Vm, Wwt, Wot, Wwt, Wwt, Ch, Dd, Dd, Dd^Edp, Dd, Md, Xu, Xu, Xu, Xu
Xu, Ql, Qxua, Xu, Ms, Ha^Fma, Aa, Aa, Cha, Ch, Ch, Wwt, Wot, Wwt, Wwt, Wot, Wwt, Ch, 4 Kh, Cd, Rp, Dd, Gs^Fts, Gs^Fts, Xu, Xu, Xu, Xu
Xu, Qxua, Qxe, Xu, Ms, Ha^Fma, Aa^Fma, Rp, Hh, 5 Kh, Ch, Wwt, Wwt, Wwt, Wwf, Wwt, Wwt^Bsb/, Ch, Gs^Fds, Gs^Fds, Gg, Rp, Rp, Gs^Fts, Xu, Xu, Xu, Xu
Xu, Qxe, Uue, Xu, Gg, Ms, Gg, Rp, Gg, Hh, Wwt, Wwt^Bsb\, Ch, Wwf, Ch, Ch, Rr^Vhc, Wwt, Wwt, Gg, Gs^Fms, Gs^Fms, Gg^Ve, Rp, Xu, Xu, Xu, Xu
Xu, Uue, Uu, Xu, Gg, Gs^Vh, Gg, Rp, Wot, Wwt, Gg, Gg, Qxua, Ch, 1 Kh, Rp, Rp, Gg, Gg, Wot, Hh, Hh^Fms, Gs^Fms, Rp, Xu, Xu, Xu, Xu
Xu, Uue, Uu, Xu, Gg, Gg, Hh, Rp, Wot, Gs^Vh, Wot, Gg, Gg, Gg, Gg, Gg, Gg, Rp, Gg, Wwt, Rp, Rp, Rp, Rp, Xu, Xu, Xu, Xu
Xu, Uu, Ur, Xu, Gg, Hh^Fp, Rp, Rp, Gg, Wot, Gg, Wwt, Wwt, Gg, Hh, Gg, Gll^Fp, Rp, Gg, Wwt, Rp, Gs^Fms, Gs^Fms, Gs^Fms, Xu, Xu, Xu, Xu
Xu, Uh, Ur, Xu, Xu, Gg^Fp, Rp, Mm, Gs^Vh, Gg, Gg, Ss^Fp, Ss, Wwt, Wot, Gg, Rp, Rp, Gg, Wwt, Gs^Fms, Rp^Vc, Rp, Gs^Fms, Xu, Xu, Xu, Xu
Xu, Xu, Ur, Ur, Rp, Gg, Gg^Fp, Rp, Rp, Gll^Fp, Gll^Fp, Gll^Fp, Ss, Ss, Wwt, Gll^Fp, Rp, Hh, Wwt, Wot, Hh, Gs^Fms, Rp, Gs^Fms, Xu, Xu, Xu, Xu
Xu, Xu, Wwf, Wwt, Wwt, Rp, Rp, Hh^Fp, Rp, Hh^Fp, Gg^Vhh, Gll^Fp, Gg, Ss, Wot, Rp, Rp^Vhcr, Wot, Gg^Vhr, Gg, Gg, Rp, Gg^Ve, Gs^Fms, Xu, 7 Xu, Xu, Xu
Uh, Wwt, Ur, Xu, Gg, Wwt, Wwf, Rp, Rp, Mm^Fp, Hh, Gg, Gg, Wot, Mv, Rp, Rp, Wot, Wwt, Gg, Rp, Rp, Hh, Gg, Xu, Xu, Kud^Ecf, Xu
Xu, Cud^Wm, Cud, Xu, Gg, Hh, Mm, Wwf, Wwt, Rp, Rp, Gg, Gg, Wot, Wot, Gg, Gg, Rp, Rp, Wwf, Wwf, Mm, Hh, Gg, Xu, Cud, Cud^Wm, Xu
Xu, Kud^Ecf, Xu, Xu, Gg, Hh, Rp, Gg, Gg, Wwt, Wot, Rp, Rp, Mv, Wot, Gg, Gg, Hh, Mm^Fp, Rp, Rp, Wwt, Wwt, Gg, Xu, Ur, Wwt, Uh
Xu, Xu, 8 Xu, Xu, Gs^Fms, Gg^Ve, Rp, Gg, Gg, Gg^Vhr, Wot, Rp^Vhcr, Rp, Wot, Ss, Gg, Gll^Fp, Gg^Vhh, Hh^Fp, Rp, Hh^Fp, Rp, Rp, Wwt, Wwt, Wwf, Xu, Xu
Xu, Xu, Xu, Xu, Gs^Fms, Rp, Gs^Fms, Hh, Wot, Wwt, Hh, Rp, Gll^Fp, Wwt, Ss^Vht, Ss, Gll^Fp, Gll^Fp, Gll^Fp, Rp, Rp, Gg^Fp, Gg, Rp, Ur, Ur, Xu, Xu
Xu, Xu, Xu, Xu, Gs^Fms, Rp, Rp^Vc, Gs^Fms, Wwt, Gg, Rp, Rp, Gg, Wot, Wwt, Ss, Ss^Fp, Gg, Gg, Gs^Vh, Mm, Rp, Gg^Fp, Xu, Xu, Ur, Uh, Xu
Xu, Xu, Xu, Xu, Gs^Fms, Gs^Fms, Gs^Fms, Rp, Wwt, Gg, Rp, Gll^Fp, Gg, Hh, Gg, Wwt, Wwt, Gg, Wot, Gg, Rp, Rp, Hh^Fp, Gg, Xu, Ur, Uu, Xu
Xu, Xu, Xu, Xu, Rp, Rp, Rp, Rp, Wwt, Gg, Rp, Gg, Gg, Gg, Gg, Gg, Gg, Wot, Gs^Vh, Wot, Rp, Hh, Gg, Gg, Xu, Uu, Uue, Xue
Xu, Xu, Xu, Xu, Rp, Gs^Fms, Hh^Fms, Hh, Wot, Gg, Gg, Rp, Rp, 6 Kh, Ch, Qxua, Gg, Gg, Wwt, Wot, Rp, Gg, Gs^Vh, Gg, Xu, Uu, Uue, Xue
Xu, Xu, Xu, Xu, Rp, Gg^Ve, Gs^Fms, Gs^Fms, Gg, Wwt, Wwt, Rr^Vhc, Ch, Ch, Wwf, Ch, Wwt^Bsb\, Wwt, Hh, Gg, Rp, Gg, Ms, Gg, Xu, Uue, Qxe, Xue
Xu, Xu, Xu, Xu, Gs^Fts, Rp, Rp, Gg, Gs^Fds, Gs^Fds, Ch, Wwt^Bsb/, Wwt, Wwf, Wwt, Wwt, Wwt, Ch, 3 Kh, Hh, Rp, Aa^Fma, Ha^Fma, Ms, Xu, Qxe, Qxua, Xue
Xu, Xu, Xu, Xu, Gs^Fts, Gs^Fts, Dd, Rp, Cd, 2 Kh, Ch, Wwt, Wot, Wwt, Wwt, Wot, Wwt, Ch, Ch, Cha, Aa, Aa, Ha^Fma, Ms, Xu, Qxua, Ql, Xue
Xu, Xu, Xu, Xu, Md, Dd, Dd^Edp, Dd, Dd, Ch, Wwt, Wwt, Wot, Wwt, Ww^Vm, Wot, Wot, Wwt, Ai, Aa, Rb, Ha, Ms, Aa, Xu, Ql, Qlf, Xue
Xu, Xu, Xu, Xu, Dd, Rd, Hd, Dd^Dc, Md, Gs, Wot, Wot, Wwt, Wwt, Wwt, Wwt, Wwt, Wot, Wot, Ms, Ha, Ha, Ha, Ha, Xu, Qlf, Uh^Ecf, Xu
Xu, Xu, Xu, Xu, Dd, Hd, Dd^Vdt, Hd, Md^Xm, Wot, Wwt, Wwt, Wwf^Ecf, Wwt, Wwt, Wwt, Wwf^Ecf, Wwt, Wot, Ms^Xm, Ha, Ha^Vhha, Ms, Ha, Xu, Xu, Xu, Xu
Xu, Xu, Xu, Xu, Dd, Dd, Dd, Dd, Md^Xm, Wot, Wwt, Wwt, Wwt, Wwt, Wwt, Wwt, Wwt, Wwt, Wot, Ms, Ha, Ha, Ms^Xm, Ms^Xm, Xu, Xu, Xu, Xu
